x,x,x,x,x,x,x,x,x,x,x,x,x
x,,b,,x,,,,,,,,x
x,,x,,x,b,x,x,x,x,x,,x
x,,x,x,,,,b,,,x,b,x
x,,,x,,x,x,x,x,x,x,,x
x,x,,x,,x,,,b,,x,,x
s,,,x,b,x,x,x,,x,x,,x
x,b,x,,,,,x,,,b,,x
x,,x,x,x,x,,x,,x,x,,x
x,,x,,b,,,x,x,x,x,,x
x,,x,,x,x,x,x,,,b,,x
x,,b,,x,,,b,,x,x,,x
x,x,x,x,x,x,f,x,x,x,x,x,x