x,x,x,x,f,x,x,x
x,x,x,x,,x,x,x
x,x,x,x,,,x,x
x,x,,,x,,x,x
x,x,b,x,b,,,x
x,,,x,,x,x,x
x,x,,b,,x,x,x
x,x,x,x,,x,,x
x,x,,,,b,,x
x,,,x,x,,x,x
x,x,x,x,x,s,x,x